NO ./textures/redbrick.xpm
SO ./textures/purplestone.xpm
EA ./textures/greystone.xpm
WE ./textures/eagle.xpm
F 157,134,98
C 98,157,104

              11111111111111111111
11111111111111000001
10000000000000000001
10000000000000000001
10000000001001000001
1000000100000W111001
10000000001001000001
10000000000000000001
11111111111111111111
