NO ./textures/redbrick.xpm
SO ./textures/purplestone.xpm
EA ./textures/greystone.xpm
WE ./textures/eagle.xpm
F 3,2,1
C 1,2,3

              11111111111111111111
1111111111111100000100000000000001
1000000000000000000100000000000001
1000000000000000000100000000000001
1000000000100100000100000000000001
1000000100000W11100000000000000011
1000000000100100000100000000000001
100000000000000000000000000000001
1111111111111111111111111111111111
